5, 7
0, 0, 6, 6, 6, 6, 0,
0, 6, 1, 6, 2, 0, 0,
0, 0, 6, 0, 2, -1, -1,
0, 7, 0, 0, 0, 0, 0, 
0, 0, -1, 0, 4, 0, 0 